00000000000000
00000000000020
00000000000010
00000000000010
00000000000010
00000000000010
00000000000010
00000000000010
00000000000010
00000000000010
01111111111110
01000000000000
0x000000000000