00000000000000
11111111111110
00000000000010
11111111111111
11111111111111
11111111111111
11111111111111
11111111111111
00000000000000
11111111111111